Amber - Poranne Piwo
Amethyst - Jestem Twój
Topaz - Góraz
Sapphire - Wynajęty Soczek
Emerald - Szmaragdowy
Ruby - Krosta
Diamond - Romb

======   RUDZI   ======
Ore - Rudzi (tak po prostu, np. Rudzi Żelazka)

Chlorophyte - Chlorofrytka
Cobalt - Inny Bochenek
Copper - Policjant
Gold - Złotko
Iron - Żelazko
Lead - Ołówek
Metorite - Spotkanioryt
Shroomite - Grzybogrosz
Silver - Sreberko
Orrichalcum - Ruda Kreda
Palladium - Ziompalium
Titanium - Kretynium

======   MEDŻIK    ======
Chaos - Bezprawie
Magic - Magiczna (jak w Kapitanie Bomba "Magiczna Flet")
Mana - Prestiż
Orb - Jabłko

======   ZWIERZĘTA   ======
Beetle - Młotek Drewniany
Bird - Ptaszek
Bug - Pluskwa
Bunny - Trusia
Butterfly - Latające Masło
Fish - Żeton
Fly - Lotnik
Grasshopper - Pchła z Murawy
Guide - Harcerka
Hoppin Jack - Dźwigarka do Zaprawiania Piwa Chmielem
Horse - Skoczek
Ladybug - Boża Krówka
Lizard - Jaszczur
Mosquito - Mszasty Rezygnant
Mouse - Podbite Oko
Parrot - Zgniła Gafa
Snail - Pomrowik
Squirrel - Prawdziwie Rządze
Turtle - Żółw
Worm - Czerw

======   MOBY   ======
Bat - Pałka
Demon Eye - Judasz Diabeł
Elemental - Pierwiastkowiec
Elf - Psotnik
Ghost - Cień
Goblin - Banknot Jednofuntowy
Golem - Cytrynowy Chodek
Harpy - Ględziator
Hornet - Sieciowy Klakson
Imp - Skrzat
Lihzahrd - Reptilian
Mimic - Imitator
Mummy - Miazga
Nimbus - Gimbus
Paladin - Hałaśliwy Kumpel
Piranha - Pani Lekkich Obyczajów
Skeleton - Kościotrup
Slime - Muł
Spectre - Specjalne Drzewo
Unicorn - Jednokukurydz
Vampire - Strzyga
Wisp - Wiecheć
Wizard - Czarnoksiężnik
Zombie - Bałwan

======   BOSSY   ======
Slime King - Król Mułu
Eye of Cthulu - Głuchy Judasz
Eater of Worlds - Zjadacz Kul Ziemskich
Brain of Cthulu - Głucha Muzgownica
Skeletron - Szkieletor
Skeletron Prime - Rozkwitnięty Szkieletor
Destroyer - Kontrtorpedowiec
Duke Fishron - Książe Romek Żeton
Plantera - Bydlaczka
Pumpking - Król Pompka
Queen Bee - Pszczela Dama
Wall of Flesh - Ogrodzenie Miąższu
Moon Lord - Władca Miesiąca
Retinazer i Spazmatism - Siatkówkazer i Skurczotator
Twins - Dwojaczki 

======   CZĘŚCI CIAŁA BOSSÓW   ======
Arm - Wysięgnik
Head - Czoło
Hand - Marynarz
Fist - Kułak

======   BIOMY   ======
Cave - Komora
Caverns - Pieczary
Corruption - Fałszowanie
Crimson - Purpur
Desert - Deser
Dungeon - Ciemnica
Forest - Knieja
Jungle - Gąszcz
Hallow - Spuszczone Psy
Hell - Cholera
Ocean - Wielka Woda
Overworld - Ponadświat
Shimmer - Migotacz
Sky - Firmament
Space - Spacja
Surface - Płaszczyzna
Temple - Rozciągacz
Underground - Metro
Underworld - Świat Przestępczy

======   KLOCKI   ======
Block - Kloc
Wall - Ogrodzenie

Brick - Równygość
Cloud - Turman
Column - Słup
Crimsand - Purpiach
Crimstone - Purpestkowy
Crystal - Zrospaczone Stoisko
Ice - Lukier
Glass - Barometr
Granite - Wieczorna Babcia
Marble - Rzeźba
Obsidian - Obsesja Indian
Platform - Peron
Sand - Piach
Slab - Kawał
Stone - Pestka
Sandstone - Piachopestka
Tiled - Tafla
Titanstone - Pestkokretyn
Tree - Choinka
Wood - Lasek

======   KOLORY   ======
Dye - Barwidło
Paint - Szminka

Black - Wrony
Blue - Przygnębiony
Cyan - Cyjankowa
Gray - Szpakowaty
Green - Nieoświadczony
Golden - Zezłocony
Lime - Wapienny
Orange - Oranżadowy
Pink - Goździk
Purple - Szkarłatny
Red - Rudy
Sky Blue - Przygnębiony Firmament
Teal - Cyraneczka
Violet - Fiołkowy
White - Czysty
Yellow - Tchórzliwy

Light - Znicz
Dark - Śniady

======   SKARBY YARRR   ======
Banner - Transparent
Relic - Zbytek
Trophy - Zdobycz
Tresure Bag - Woreczek Finansowy

======   PILLARY   ======
Pillar - Wyrostek Stawowy
Nebula - Obłoczek
Solar - Słońce
Stardust - Pyłek Gwiazdora
Vortex - Kłębowisko

======   PRZYMIOTNIKI   ======
Bloody - Cholerny
Bottled - Pijany
Bright - Bystre
Broken - Spłukany
Celestial - Niebieski
Cursed - Cholerny
Deep - Chytra
Devil - Kaduk
Enchanted - Zafascynowany
Evil - Paskudny
Frozen - Skostniały
Fungi - Grzybiasty
Giant - Olbrzymi
Glowing - Promieniujący
Great - Hojny
Guardian - Konduktor
Intense - w Napięciu
Large - Poważny
Lesser - Gorszy
Living - Zamieszkały
Lucky - Trafiający
Molten - Ciekły
Multicolored - Stukrasny
Necromantic - Nie Koniecznie Romantyczny
Rain - Dżdżysta
Rare - Klawy
Rusty - Ośniedziały
Shadow - Szpiegujący
Shining - Awanturujący
Smooth - Spokojny
Spiked - Wzbogacony
Spiky - Kłosokształtny
Stained - Zbejcowany
Strange - Kuriozalny
Super - Kwadratowy
Undead - Nienieboszczyk
Vile - Szmatławy
Vicious - Okrutny
Watcher - Zegarmistrz
Wooden - Sztywny

======   ROŚLINKI   ======
Berry - Ikra
Flower - Pospolitnik
Fruit - Pedzio
Fungus - Grzybek
Kelp - Listownicowce
Leaf - Kartka
Moss - Torfowisko
Mushroom - Parweniusz
Pear - Puszko
Root - Źródłosłów
Rose - Sitko
Seed - Plemię
Spore - Rozmnóżka

======   MEBLE   ======
Altar - Ołtarz
Anvil - Zło
Bed - Grządka
Bookcase - Pokrowiec na Rejestry
Candle - Znicz
Chair - Prezes
Chandelier - Pająk
Chest - Pudełko
Door - Podwoje
Fence - Meliniarz
Flag - Bandera
Forge - Kuźnia
Lamp - Jagnię
Lantern - Kaganiec
Music Box - Kwadratowa Partytura
Shelf - Gzyms
Shower - Zgraja
Sign - Sygnał
Station - Popas
Statue - Posążek
Table - Biesiadnik
Vase - Wazon
Window - Frazes
Work Bench - Ławka Robocza

====== KOSTIUMY ========
Boots - Czyścibut
Breastplate - Piersiopłyt
Bucket - Czerpak
Cloak - Przykrywka
Dress - Negliż
Gauntlet - Pojedynek
Greaves - Skwarki
Hat - Kapelusz
Headgear - Przyłbica
Helmet - Szyszak
Hood - Kapiszon
Leggings - Rajtuzy
Mask - Maszkaron
Necklace - Karkówka
Pants - Kalesony
Patch - Skrawek
Plate Mail - Płytowa Poczta
Robe - Szlafrok
Scalemail - Złuszczona Poczta
Shield - Puklerz
Shirt - Podkoszulek
Shoe - Trzewik
Suit - Krawaciarz
Tiara - Diadem
Tuxedo - Marynarka
Wings - Błotniki

======   BRONIE   ======
Arrow - Opieprzacz
Axe - Cięcie
Bomb - Papieros
Boomerang - Wybuchowy Odbijacz
Bottle - Flaszka
Bullet - Byczek
Cannon - Kieszonkowiec
Chainsaw - Dybowe Porzekadło
Claymore - Bardziejtrup
Dart - Fałdzik
Drill - Świder
Fist - Kułak
Greataxe - Hojnyciach
Grenade - Gaśnica
Gun - Spluwa
Halberd - Sieniobród
Hamaxe - Hamak
Hammer - Kurek
Jackhammer - Jackurek
Knife - Rzezak
Rod - Rózga
Partisan - Zwolennik
Pickaxe - Cięty Kaprys
Pike - Szczupak
Repeater - Kapuś
Rifle - Gwintówka
Saber - Koncerz
Scepter - Berło
Scope - Kompetencja
S.D.M.G. - Kwadratowa Spluwa Aparatowego Delfina
Shotbow - Strzelecki Ukłon
Shortsword - Ukłod Szpadowy
Spear - Dzida
Staff - Pała
Sword - Szpada
Trident - Trójszczerb
Wand - Szczoteczka
Waraxe - Warszawa
Warhammer - Bojokurek

======   ITEMKI   ======
Alchemy - Wszystkie Schematy
Ball - Kłębek
Balloon - Dymek
Band - Zespół
Bar - Baton
Blizzard - Zadymka
Blood - Farbowany
Bone - Fiszbin
Book - Rejestr
Brass - Forsa
Bubble - Gul Gul
Bundle - Tobół
Caster - Pieprzniczka
Cenx - Grox
Coat - Owłosienie
Crimtane - Puropalony
Day - Dniówka
Diabolist - Cukrzykowiec
Doll - Ślicznotka
Egg - Jajco
Emblem - Godło
Feather - Szpunt
Fire - Przeciwpożarowy
Flame - Miłość
Flask - Kolba
Frost - Fiasko
Fury - Megiera
Globe - Globus
Gothic - Barbarzyńskie
Gradient - Nachylenie
Grave - Mogiła
Gravity - Powaga
Gum - Żywica
Hammer - Iglica
Hive - Ośrodek Wielkiego Ożywienia
Honey - Rewelka
Hook - Atrakcja
Horseshoe - Skoczkotrzewik
Husk - Wrak
Ichor - Posoka
Machine - Aparat
Jelly - Kisiel
Key - Klawisz
Magnet - Potentat
Man - Człek
Map - Gęba
Metal - Masa Szklana
Moon - Miesiąc
Nightmare - Nocna Klacz
Obelisk - Słuchacz Krocza
Pirate - Plagiator
Poison - Jad
Potion - Napój
Powder - Krzepa
Pressure Plate - Napięty Talerz
Pygmy - Karzełski
Rainbow - Dżdżysty Ukłon
Skull - Skrzep
Shell - Łupina
Sigil - Znacznik
Sled - Tobogan
Sniper - Szperacz
Snow - Pianka
Soul - Duch
Spike - Kłujka
Spine - Cierń
Sphere - Gałka
Star - Gwiazdor
Sun - Niedziela
Tentacle - Wąsy
Torch - Żagiew
Toy - Cacko
Trap - Bajzel
Venom - Przyjaciel
Vial - Ampułka
Voodoo - Wiara w Czary
Warp - Wypaczenie
Watch - Straż
Water - Jezioro

======   DIALOGOWE   ======
Crowded - Zciżbowany
Home - Ojczyzna
I Dislike - Idiosynkrazuję
I Hate - Ja bardzo nie lubić
I Like - Sympatyzuje
I Love - Romansuje