Amber - Poranne Piwo
Amethyst - Jestem Twój
Diamond - Romb
Ember - Niedopałek
Emerald - Szmaragdowy
Ruby - Krosta
Sapphire - Wynajęty Soczek
Topaz - Góraz

======   RUDZI   ======
Ore - Rudzi (tak po prostu, np. Rudzi Żelazka)

Adamantite - Durny Adaś
Bronze - Spiżowe
Chlorophyte - Chlorofrytka
Cobalt - Inny Bochenek
Copper - Policjant
Demonite - Diabłonit
Fossil - Odlew
Gold - Złotko
Hellstone - Cholernapestka
Iron - Żelazko
Lead - Ołówek
Luminite - Światłonit
Meteorite - Spotkanioryt
Mythril - Baśnium
Shroomite - Grzybogrosz
Silver - Sreberko
Orrichalcum - Ruda Kreda
Palladium - Ziompalium
Platinum - Talerzinum
Tin - Patelnia
Titanium - Kretynium
Tungsten - Wolfram

======   MEDŻIK    ======
Chaos - Bezprawie
Magic - Magiczna (jak w Kapitanie Bomba "Magiczna Flet")
Mana - Prestiż
Orb - Jabłko
Scroll - Zakrętas

========== NPC ============
Angler - Żabnica
Arms Dealer - Rozdający Karty Rękoma
Demolitionist - Demolka
Dryad - Sucha Reklama
DyeTrader - Handlowiec Barwidło
Clothier - Płachtacz
Cyborg - Organizm Cybernetyczny
Goblin Tinkerer - Druciarz Banknot Jednofuntowy
Golfer - Gracz Golfa
Guide - Harcerka
Mechanic - Robotnik
Merchant - Handlowiec
Nurse - Pszczoła Karmicielka
Painter - Szminkator
PartyGirl - Facetka Wieczornica
Pirate - Korsarz
Princess - Królewna
Santa Claus - Mikołaj Mikołaj
Steampunker - Parowa Kalamburzystka
Stylist - Dekorator
Tavernkeep - Wikt Gospody
Tax Collector - Komutator Wysiłku
Truffle - Trufla
Witch Doctor - Lekarz to Baba
Wizard - Czarnoksiężnik
Zoologist - Zwierzyńcowa Logistyk

======   ZWIERZĘTA   ======
Critter - Krytyk

Beetle - Młotek Drewniany
Bird - Ptaszek
Bug - Pluskwa
Bunny - Trusia
Butterfly - Latające Masło
Cat - Złośliwa Kobieta
Dog - Facet 
Fish - Żeton
Fly - Lotnik
Frog - Krzyżownica
Grasshopper - Pchła z Murawy
Guide - Harcerka
Hoppin Jack - Dźwigarka do Zaprawiania Piwa Chmielem
Horse - Skoczek
Ladybug - Boża Krówka
Lizard - Jaszczur
Mosquito - Mszasty Rezygnant
Mouse - Podbite Oko
Parrot - Zgniła Gafa
Shrimp - Człowieczyna
Snail - Pomrowik
Spider - Migotacz
Squirrel - Prawdziwie Rządze
Tiger - As
Turtle - Żółw
Worm - Czerw

======   MOBY   ======
Bat - Pałka
Creature - Kreatura
Demon Eye - Judasz Diabeł
Dragon - Huzar
Elemental - Pierwiastkowiec
Elf - Psotnik
Gentleman - Mężczyzna Kulturalny
Ghost - Cień
Goblin - Banknot Jednofuntowy
Harpy - Ględziator
Hornet - Sieciowy Klakson
Imp - Skrzat
Lihzahrd - Reptilian
Merfolk - Syrludka
Mimic - Imitator
Monster - Dziwoląg
Mummy - Miazga
Nimbus - Gimbus
Paladin - Hałaśliwy Kumpel
Piranha - Pani Lekkich Obyczajów
Pixie - Chochlik
Skeleton - Kościotrup
Slime - Muł
Spectre - Specjalne Drzewo
Unicorn - Jednokukurydz
Vampire - Strzyga
Wisp - Wiecheć
Wizard - Czarnoksiężnik
Zombie - Bałwan

======   BOSSY   ======
Boss - Kierownik

Brain of Cthulu - Głucha Muzgownica
Destroyer - Kontrtorpedowiec
Duke Fishron - Książe Romek Żeton
Eater of Worlds - Zjadacz Kul Ziemskich
Eye of Cthulu - Głuchy Judasz
Empress of Light - Mało Ważna Cesarzowa
Lunatic Cultist - Wariat Witacz
Golem - Cytrynowy Chodek
Moon Lord - Władca Miesiąca
Plantera - Bydlaczka
Queen Bee - Pszczela Dama
Queen Slime - Mula Dama
Skeletron - Szkieletor
Skeletron Prime - Rozkwitnięty Szkieletor
Slime King - Król Mułu
Wall of Flesh - Ogrodzenie Miąższu

Retinazer i Spazmatism - Siatkówkazer i Skurczotator
Twins - Dwojaczki 

Betsy - Zakładacz
Dark Mage - Śniady Mag
Deerclops - Klopsik Rogaty
Everscream - Do Licha Zabawny Facetk
Flying Dutchman - Latający Niemiecki Gość
Martian Saucer - Marsjańska Panewka
Mourning Wood - Sztywny Lament
Ice Queen - Królowa Lukru
Pumpking - Król Pompka
Torch God - Boski Palnik
Ogre - Ludojad
Ocram - Kolor

======   CZĘŚCI CIAŁ   ======
Arm - Wysięgnik
Body - Ścierwo
Ears - Kłosie
Fist - Kułak
Head - Czoło
Hand - Marynarz
Legs - Udźce	(Udziec)
Tail - Miotła

======   BIOMY   ======
Biome - Mój Życiorys

Cave - Komora
Caverns - Pieczary
Corruption - Fałszowanie
Crimson - Purpur
Desert - Deser
Dungeon - Ciemnica
Forest - Knieja
Jungle - Gąszcz
Graveyard - Poważny Dziedziniec
Hallow - Szczute Psy
Hell - Cholera
Ocean - Wielka Woda
Otherworld - Odmiennoświat
Overworld - Ponadświat
Shimmer - Migotacz
Sky - Firmament
Space - Spacja
Surface - Płaszczyzna
Temple - Rozciągacz
Underground - Metro
Underworld - Świat Przestępczy

======   KLOCKI   ======
Block - Kloc
Wall - Ogrodzenie
Wallpaper - Wypracowane Ogrodzenie

Ash Wood - Jesionowy Lasek
Boreal Wood - Sztywna Północ
Ebonwood - Gnatodrzew
Palm Wood - Czułkowy Lasek
Pearlwood - Kroplodrzew
Shadewood - Kloszodrzew

Bamboo - Syn Bambika
Blocker - Klocker
Brick - Równygość
Board - Szachownica
Cactus - Kaktus
Clay - Trup
Cloud - Turman
Column - Słup
Crimsand - Purpiach
Crimstone - Purpestkowy
Crystal - Szkiełko do Zegarka
Dynasty - Paskudne
Ebonsand - Gnatopiach
Ebonstone - Gnatopestka
Ice - Lukier
Gemcorn - Cackokukurydza
Gemspark - Cackofircyk
Glass - Barometr
Granite - Wieczorna Babcia
Marble - Rzeźba
Mud - Zaprawa Murarska
Obsidian - Obsesja Indian
Pearl - Kropla
Pearlsand - Kroplopiach
Pearlstone - Kroplopestka
Sand - Piach
Slab - Kawał
Skyware - Towar Firmamentu
Stone - Pestka
Sandstone - Piachopestka
Tiled - Tafla
Titanstone - Pestkokretyn
Tree - Choinka
Web - Błona Pławna
Wood - Lasek

======   KOLORY   ======
Dye - Barwidło
Hair Dye - Futrzaste Barwidło
Paint - Szminka

Black - Wrony
Blue - Przygnębiony
Brown - Kasztanowy
Cyan - Cyjankowa
Gray - Szpakowaty
Green - Nieoświadczony
Golden - Zezłocony
Lime - Wapienny
Magenta - Fuksyna
Maroon - Kasztanowaty
Orange - Oranżadowy
Pink - Goździk
Purple - Szkarłatny
Red - Rudy
Sky Blue - Przygnębiony Firmament
Teal - Cyraneczka
Violet - Fiołkowy
White - Czysty
Yellow - Tchórzliwy

Light - Znicz
Dark - Śniady
Negative - Przecząca

======   SKARBY YARRR   ======
Banner - Transparent
Relic - Zbytek
Trophy - Zdobycz
Treasure Bag - Woreczek Finansowy

======   PILLARY   ======
Pillar - Wyrostek Stawowy
Nebula - Obłoczek
Solar - Słońce
Stardust - Pyłek Gwiazdora
Vortex - Kłębowisko

======   PRZYMIOTNIKI   ======
Aether - Wieczny
Ancient - Starodawny
Bloody - Farbowany
Bottled - Pijany
Bottomless - Bez Spodni
Bouncy - Pełen Wigoru
Bright - Bystre
Broken - Spłukany
Celestial - Niebieski
Cosmic - Pozaziemski
Cursed - Cholerny
Dead - Śnięty
Decorative - Ornamentalny
Deep - Chytra
Devil - Kaduk
Dripping - Sos
Enchanted - Zafascynowany
Evil - Paskudny
Fallen - Poległy
Frozen - Skostniały
Fungi - Grzybiasty
Giant - Olbrzymi
Glowing - Promieniujący
Great - Hojny
Guardian - Konduktor
Hanging - Powieszenie Zbrodniarza
Hardened - Zahartowany
Heavenly - Boski
Hidden - Przyczajony
Intense - w Napięciu
Large - Poważny
Lesser - Gorszy
Living - Zamieszkały
Lucky - Trafiający
Mechanical - Bezwiedny
Molten - Ciekły
Multicolored - Stukrasny
Necromantic - Nie Koniecznie Romantyczny
Royal - Niebywały
Rusty - Ośniedziały
Shadow - Szpiegujący
Shining - Awanturujący
Smooth - Spokojny
Spicy - Drastyczny
Spiked - Wzbogacony
Spiky - Kłosokształtny
Stained - Zbejcowany
Sticky - Kłopotliwy
Strange - Kuriozalny
Super - Kwadratowy
Tattered - Gałgańskie
Treacherous - Judaszowski
Undead - Nienieboszczyk
Vile - Szmatławy
Vicious - Okrutny
Watcher - Zegarmistrz
Wicked - Figlarny
Wild - Nieoswojony
Wondering - Błądzący
Wooden - Sztywny

Uncommon - Niebywały
Rare - Na Pół Surowy

======   ROŚLINKI   ======
Apple - Jabłuszko
Berry - Ikra
Cactus - Kaktus
Flower - Pospolitnik
Fruit - Pedzio
Fungus - Grzybek
Grass Seeds - Plemiona Muraw
Kelp - Listownicowce
Leaf - Kartka
Mushroom - Parweniusz
Pear - Puszko
Pumpkin - Rodzina Pompki
Rich Mahogany - Pożywna Mahoń
Root - Źródłosłów
Rose - Sitko
Sapling - Młode Drzewko
Seed - Plemię
Shadewood - Abażurodrzew
Shiverthorn - Dygotek Kolczasty
Spore - Rozmnóżka
Thorn - Cierń

Moss - Torfowisko
Argon - Argumenton
Helium - Śmigłowcum
Krypton - Krypton
Neon - Nowoczesnon
Xeon - Obcon

======   MEBLE   ======
Altar - Ołtarz
Anvil - Zło
Ash - Jesion
Barrel - Beczułka
Bathtub - Faska Zdrój
Bed - Grządka
Bookcase - Pokrowiec na Rejestry
Boulder - Głaz Eratyczny
Bowl - Kula do Gry w Kręgle
Bulb - Gruszka
Cage - Kabina
Campfire - Znicz Kolonialny
Candle - Kandela
Candelabra - Biustonosz Kandela
Chamber - Nocnik
Chandelier - Pająk
Chair - Prezes
Chest - Pudełko
Clock - Strzałka
Couch - Wersalka
Door - Podwoje
Dresser - Kredens
Fence - Meliniarz
Flag - Bandera
Forge - Zakład Metalurgiczny
Fountain - Źródło
Furnace - Piekło
Geyser - Piecyk Gazowy
Lamp - Jagnię
Lantern - Kaganiec
Log - Raport Wiertniczy
Loom - Krosno
Mill - Kierat
Monolith - Jedna Cząstka Pomarańczy
Music Box - Kwadratowa Partytura
Painting - Pędzlowanie
Piano - Delikatnie
Picture - Malowidło
Platform - Peron
Poster - Afisz
Pot - Nocnik
Potted - Konserwowy
Pylon - Wieża Stalowa
Rack - Etażerka
Shelf - Gzyms
Shower - Zgraja
Sign - Sygnał
Sink - Rynsztok
Sofa - Kanapka
Station - Popas
Statue - Posążek
Table - Biesiadnik
Timer - Chronometrażysta
Toilet - Ubranie
Trapped Chest - Zbajzelowane Pódełko
Trap Door - Podwoje Bajzelu
Vase - Wazon
Void Bag - Nieważne Prawnie Branie Do Kieszeni
Window - Frazes
Wire - Depesza
Work Bench - Ławka Robocza

Floor - Klepisko

Life Crystal - Okres Użytkowania Szkiełka do Zegarka
Life Fruit - Okres Użytkowania Pedału

====== KOSTIUMY ========
Armor - Pancerz
Boots - Czyścibuty
Breastplate - Piersiopłyt
Bucket - Czerpak
Cap - Nakrętka
Cape - Przylądek
Chainmail - Dybowa Poczta
Chestplate - Pódełkopłyt
Cloak - Przykrywka
Coat - Owłosienie
Costume - Kostium
Cowl - Ceber
Dress - Negliż
Fur - Zwierzyna
Gauntlet - Pojedynek
Gear - Bzdura
Glove - Gochanek
Goggles - Wytrzeszczone Oczy
Greaves - Skwarki
Hat - Kapelusz
Headgear - Przyłbica
Helm - Sterownica
Helmet - Szyszak
Hood - Kapiszon
Hoodie - Kurtka z Kapturem
Jacket - Żakiet
Leggings - Rajtuzy
Mask - Maszkaron
Necklace - Karkówka
Pants - Kalesony
Patch - Skrawek
Plate Mail - Płytowa Poczta
Ring - Szajka
Robe - Szlafrok
Scalemail - Złuszczona Poczta
Shield - Puklerz
Shirt - Podkoszulek
Shoe - Trzewik
Skirt - Babeczka
Suit - Krawaciarz
Sweater - Wyzyskiwacz
Tiara - Diadem
Tunic - Błona
Tuxedo - Marynarka
Uniform - Jednolity
Vest - Półkoszulka
Wig - Ochrzan
Wings - Błotniki

====== AKCESORIA =======
Minecart - Gruba Bryczka

======   BRONIE   ======
Arrow - Opieprzacz
Axe - Cięcie
Blade - Brzeszczot
Bomb - Papieros
Boomerang - Wybuchowy Odbijacz
Bottle - Flaszka
Broadsword - Pałasz
Bullet - Byczek
Cannon - Kieszonkowiec
Chakram - Koło
Chainsaw - Dybowe Porzekadło
Claymore - Bardziejtrup
Counterweight - Licznik Sztang
Dart - Fałdzik
Drill - Świder
Fishing Pole - Maszt Żetonowania
Fist - Kułak
Greataxe - Hojnyciach
Grenade - Gaśnica
Gun - Spluwa
Halberd - Sieniobród
Hamaxe - Hamak
Hammer - Kurek
Jackhammer - Jackurek
Lance - Kopia
Knife - Rzezak
Launcher - Obiadownik
Mace - Buzdygan
Rod - Rózga
Partisan - Zwolennik
Pickaxe - Cięty Kaprys
Pike - Szczupak
Repeater - Kapuś
Rifle - Gwintówka
Rocket - Świeca Samochodowa
Saber - Koncerz
Scepter - Berło
Scope - Kompetencja
S.D.M.G. - Kwadratowa Spluwa Aparatowego Delfina
Shotbow - Strzelecki Ukłon
Shortsword - Ukłod Szpadowy
Spear - Dzida
Staff - Pała
Sword - Szpada
Terraformer - Gruntoformierz
Turret - Baszta
Trident - Trójszczerb
Wand - Szczoteczka
Waraxe - Warszawa
Warhammer - Bojokurek
Whip - Kańczug
Yoyo - Kretyn

======   ITEMKI i INNE   ======
Item - Paragraf

Absorbant Sponge - Wsiąkające Wycieradło
Acid - Cierpkie
Alchemy - Wszystkie Schematy
Angel - Inwestor
Arcane - Magiczna
Bait - Postój
Ball - Kłębek
Balloon - Dymek
Band - Zespół
Bar - Baton
Beam - Balansjer
Blood - Farbowany
Bone - Gnat
Book - Rejestr
Bottle -  Flaszka
Brass - Forsa
Bubble - Gul Gul
Bundle - Tobół
Cake - Cegiełka
Caster - Pieprzniczka
Cenx - Grox
Coil - Wężownica
Crate - Grat
Crimtane - Puropalony
Crown - Ciemię
Diabolist - Cukrzykowiec
Doll - Ślicznotka
Echo - Huczenie
Egg - Jajco
Emblem - Godło
Feather - Szpunt
Fin - Żebro
Fire - Znicz
Fishing Bobber - Żeton na Szturchnięcie Piwa
Flame - Miłość
Flare - Rozszerzenie
Flask - Kolba
Frost - Fiasko
Fury - Megiera
Gas - Benzyna
Galaxy - Droga Mleczna
Globe - Gałka Oczna
Glow - Rumieńce
Glowstick - Rumieńcokij
Gothic - Barbarzyńskie
Gradient - Nachylenie
Grave - Mogiła
Gravity - Powaga
Gum - Żywica
Guy - Straszydło
Hair - 	Futro
Hammer - Iglica
Heart - Kier
Hive - Ośrodek Wielkiego Ożywienia
Honey - Rewelka
Hook - Atrakcja
Horseshoe - Skoczkotrzewik
Hunter - Zegarek Kopertowy
Husk - Wrak
Ichor - Posoka
Inferno - Nie Wywnioskowany
Jar - Dzban
Kit - Rynsztunek
Kite - Samolot
Lava - Magma
Machine - Aparat
Jack 'O Lantern - Jacko Kaganiec
Jelly - Kisiel
Key - Klawisz
Magnet - Potentat
Man - Człek
Map - Gęba
Metal - Masa Szklana
Mold - Pleśń
Moon - Miesiąc
Nightmare - Nocna Klacz
Obelisk - Słuchacz Krocza
Pipe - Fujarka
Pirate - Plagiator
Plant - Fabryka
Plush - Włochacz
Poison - Jad
Powder - Krzepa
Pressure Plate - Napięty Talerz
Pygmy - Karzełski
Rainbow - Dżdżysty Ukłon
Restoration - Restauracja
Rope - Stryczek
Seashell - Morski Nabój
Skin - Kutwa
Skull - Skrzep
Shell - Nabój
Sigil - Znacznik
Shard - Czerep
Sled - Tobogan
Sniper - Szperacz
Snow - Pianka
Solution - Rozwiązanie
Soul - Duch
Spike - Kłujka
Spine - Cierń
Sphere - Gałka
Spooky - Szpiegowski
Star - Gwiazdor
Steampunk - Parowy Kalamburek
Stinger - Zapora Drogowa w Kształcie Kolców
Style - Dekoracja
Summon - Pozywacz
Sun - Niedziela
Tentacle - Wąsy
Torch - Palnik
Tower - Holownik
Town - Miasto Prowincjonalne w USA
Toy - Cacko
Trap - Bajzel
Venom - Przyjaciel
Vial - Ampułka
Voodoo - Wiara w Czary
Warp - Wypaczenie
Watch - Uważaj na
Water - Jezioro
Wind - Dęty

====== EWENTY ========
Blood Moon - Miesiąc Farbowany
Blizzard - Zadymka
Christmas - Mama Chrystusa
Solar Eclipse - Solarne Ćmienie
Party - Partia

Goblin Invasion - Falnga banknotów jednofuntowych
Pirate Invasion - Falnga korsarzy
Martian Madness - Marsjańska Wścieklizna
Old One's Army - Falanga Każdziusieńkiego Sędziwca
Pumpkin Moon - Miesiąc Rodu Pompki
Frost Moon - Miesiąc Kostniący
Frost Legion - Fiasko Legii

Weather - Aura
Rain - Dżdżystość
Slime Rain - Mula Dżdżystość
Sandstorm - Piaskowa Zawierucha
Windy Day - Niepoważny Świt

Full Moon - Napchany Miesiąc

Morning - Przedpołudnie
Day - Świt
Night - Wieczór
Midnight - Środek Wieczoru
====== POTKI =========
Potion - Napój

Healing - Gojenie : Zdrowienie

======= UI ===========
After - Według
All - Zupełnie
Any - Który
Back - Plecy
Before - Wobec
Bestiary - Najlepszy Diadem
Buy - Okup
Cancel - Skreślać
Catch - Zaczepić
Change - Przełom
Clear - Klarowny
Click - Trzask
Close - Dobij targu
Coin - Bilon
Craft - Łódź
Effect - Konsekwencje
Emote - Emocja
Entrance - Ocznik
Equip - Zaopatrzyj
Exit - Wylot
Game - Hazard
Hide - Skóra
Inventory - Remanent
Join - Wstąp
Left - Lewy / Pozostały
Menu - Jadłospis
Misc - Składankowy
More - Raczej
Open - Ujawnij 
Place - Posiadłość
Quality - Cecha
Requires - Żąda
Return - Riposta
Scale - Tabela
Select - Dobierz
Setting - Nastawienie Kości
Show - Impreza
Stack - Komin
Swap - Przehandlować
Switch - Wyłącznik
Take - Jeść
Zoom - Brzęczenie

On - Na
Off - Precz
Enabled - Łagodzący
Disabled - Niepełnosprawny 

Large - Obszarny
Big - Cielna
High - Odurzone Narkotykiem
Medium - Średnio Wysmażone
Low - Ciche
Small - Skromny
Little - Małostkowy
Tiny - Malusieńki

Normal - Prostopadła

Expert - Rzeczoznawca
Master - Gospodarz

HP - Kropka Sanitarna
MP - Kropka Prestiżowa

Cursor - Przesuwka
Title - Krzta
Trash - Tandeta
Slot - Żłobek

Time - Godzina Śmierci
Second - Drugi

====== Statusy =======
Damage - Upośledzenie
Damage taken - Wzięte Upośledzenia
Defence - Pozwany
Fishing Power - Wartości Żetonu
Spelunker - Grotołaz
-proof - Dowód Istnienia

======   DIALOGOWE   ======
Crowded - Zciżbowany
Home - Ojczyzna

I Dislike - Idiosynkrazuję
I Hate - Ja bardzo nie lubić
I Like - Sympatyzuje
I Love - Romansuje
I prefer - Awansuje <kogoś>

I'm feeling - Jestem bomba
I'm used - Jestem wykorzystany
I'm far - Jestem w znacznym stopniu

Happy - Błogosławiony
Happiness - Błogostan

Death - Zgon

======   TOOLTIPY   ======

Accessory - Współwinny
Ability - Dar
Able to - Utalentowany w
Activates when a player steps on it - Ożywia, gdy aktor po niej stepuje
Breathing - smakowanie
Cause - powoduje
Can also apply coatings - Potrafi również smarować panierki
Can be placed in - Potrafi być ulokowany pośród
Chance - ryzyko
Chance to not consume - ryzyko nie zjedzenia
Confuse - bałamucić
Cooldown - Ostudzenie
Critical strike chance - ryzyko poważnego chluśnięcia
Damage - upośledzenie
Decrease - uszczupla
Defense - Obronność
Enemies are more likely to target you - Nieprzyjaciele są bardziej obiecujący w kierowaniu się tobą
Essence - wyciąg
Fall damage - Jesienne upośledzenia
Falling - incydent
Grants the ability - Przyznaje talent
Greatly - Hojnie
Hold - Piastować
Holder - Okaziciel
Immune - Ubezpieczony
Immunity - obojętność na
Increased - wzmożył
Increases jump height - Wzmaga inensywność susów
Increases maximum mana - Wzmaga maksymalny prestiż
Increases your max number of minions by - Wzmaga twój maksymalny wpiernicz sługusom o
Inflict - wyrządzać
Into - W sprawie
Knockback - Odmowa
Life regeneration - Resustytacja okresu użytkowania
Melee - utarczka
Minor - Nieletnie
Multiple - sklep sieciowy
Nearby - Pobliskich
Movement speed - chyżość wypróżniania
Permanently - Trwale
Pet - Pieszczoch
Pickup - pikap
Powerful - możny
Provides - dostarcza
Range - Donośność
Ranged - kuchenka
Reduced damage taken by - Zniżki na zażyte upośledzenia
Reduced mana cost - zniżka na cenę prestiżu
Reduce - zaniżyć
Resistance - ruch oporu
Restore - Odrestaurowuje
Save ammo - ocalenie strzeliwa
Sell well - wykantować studnię
Shoot - filmować
Shoots - filmuje
Spreads - Rozpościera
A small explosion that will destroy most tiles - Skromny wybuch, który zrujnuje większość dachówek
Spawn - Ikra
Striking enemies - strajkujących nieprzyjaciół
Summons - Pozywa
Summons ... to fight for you - Pozywa ... by sprzeczał się dla ciebie
Taking - Zjedzeniu
Target - Kierować
Tool range - donośność kujonów
Used for basic crafting - Przyzwyczajony do nudnych rzemiosł
Used to make - Przyzwyczajony do konstruowania
View - Opinia
When damaged - W przypadku upośledzenia